shrpubw    - создание общей папки
netplwiz   - включение/отключение учётной записи Администратора

Accessibility Controls - (Специальные возможности) - access.cpl
Add Hardware Wizard - (установка оборудования )- hdwwiz.cpl
Add/Remove Programs - (установка/удаление программ) - appwiz.cpl
Administrative Tools - (администрирование) - control admintools
Automatic Updates - (Автоматическое обновление) - wuaucpl.cpl
Bluetooth Transfer Wizard - (?) - fsquirt
Calculator - (калькулятор) - calc
Certificate Manager - (Менеджер сертификатов) - certmgr.msc
Character Map - (Таблица символов) - charmap
Check Disk Utility - (Проверка диска) - chkdsk
Clipboard Viewer - (Просмотр буфер обмена) - clipbrd
(Учетные записи) - control userpasswords
Command Prompt - (Командная строка) - cmd
Component Services - (Служба компонентов) - dcomcnfg
Computer Management - (Управление компьютером) - compmgmt.msc
(Дата\время) - timedate.cpl
(Общие ресурсы DDE) - ddeshare
Direct X Control Panel - (Панель управления Direct X)(Если установлено)* - directx.cpl
Direct X Troubleshooter - (Диагностика Direct X) - dxdiag
Disk Cleanup Utility - (Мастер очистки диска) - cleanmgr
Disk Defragment - (Дефрагментация) - dfrg.msc
Disk Management - (Управление дисками) - diskmgmt.msc
Disk Partition Manager - (Управление разделами) - diskpart
Display Properties - (Свойства: Экран) - control desktop
Display Properties - (Свойства: Экран) - desk.cpl
Display Properties (w/Appearance Tab Preselected) - (у меня Свойства: Экран/заставка) - control color
Dr. Watson System Troubleshooting Utility - (Отладчик Dr. Watson) - drwtsn32
Driver Verifier Utility - (Диспетчер проверки драйверов) - verifier
Event Viewer - (Просмотр событий) - eventvwr.msc
File Signature Verification Tool - (Проверка сигнатур системных файлов) - sigverif
Findfast - (Вроде быстрый поиск? в XP Prof Sp1 не нашел ) - findfast.cpl
Folders Properties - (Свойства папки) - control folders
Fonts control - (Папка Шрифты) - fonts
Fonts Folder - (Папка Шрифты) - fonts
Free Cell Card Game - (Игра Солитер) - freecell
Game Controllers - (Игровые устройства) - joy.cpl
Group Policy Editor - (XP Prof) (Групповые политики) - gpedit.msc
Hearts Card Game - (Игра "Черви") - mshearts
Iexpress Wizard - (Мастер встроенного архиватора iexpress) - iexpress
Indexing Service - (Служба индексирования) - ciadv.msc
Internet Properties - (Свойства:Интернет) - inetcpl.cpl
IP Configuration (Display Connection Configuration) - (Отобразить полную информацию о настройке параметров) - ipconfig /all
IP Configuration (Display DNS Cache Contents) - (Отобразить содержимое кэша ДНС) - ipconfig /displaydns
IP Configuration (Delete DNS Cache Contents) - (Очистить кэш разрешений ДНС) - ipconfig /flushdns
IP Configuration (Release All Connections) - (Освободить IP-адрес для указанного адаптера) - ipconfig /release
IP Configuration (Renew All Connections) - (Обновить IP-адрес для указанного адаптера) - ipconfig /renew
IP Configuration (Refreshes DHCP & Re-Registers DNS) - (Обновление DHCP-аренды и перерегистрация ДНС) - ipconfig /registerdns
IP Configuration (Display DHCP Class ID) - (Отобразить все допустимые для этого адаптера коды DHCP-классов) - ipconfig /showclassid
IP Configuration (Modifies DHCP Class ID) - (изменить код DHCP-класса) - ipconfig /setclassid
Java Control Panel (Если установлено) - (Панель управления Java) - jpicpl32.cpl
Java Control Panel (Если установлено) - (Панель управления Java) - javaws
Keyboard Properties - (Свойства: клавиатура) - control keyboard
Local Security Settings - (Настройки безопасности) - secpol.msc
Local Users and Groups - (Локальные пользователи и группы) - lusrmgr.msc
Logs You Out Of Windows - (Завершение сеанса) - logoff
Microsoft Chat - (Чат) - winchat
Minesweeper Game - (Игра сапер) - winmine
Mouse Properties - (Свойства:мышь) - control mouse
Mouse Properties - (Свойства:мышь) - main.cpl
Network Connections - (Сетевые подключения) - control netconnections
Network Connections - (Сетевые подключения) - ncpa.cpl
Network Setup Wizard - (Мастер сетевых подключений) - netsetup.cpl
Notepad - (Запуск Блокнота) - notepad
Nview Desktop Manager (Если установлено) - (имхо, менеджер рабочего стола Nvidia) - nvtuicpl.cpl
Object Packager - (Упаковщик объектов) - packager
ODBC Data Source Administrator - (Администратор источников данных ODBC) - odbccp32.cpl
On Screen Keyboard - (Экранная клавиатура) - osk
Performance Monitor - (Производительность) - perfmon.msc
Performance Monitor - (Производительность) - perfmon
Phone and Modem Options - (Свойства:телефон и модем) - telephon.cpl
Power Configuration - (Свойства:электропитание) - powercfg.cpl
Printers and Faxes - (Принтеры и факсы) - control printers
Printers Folder - (Папка принтеры) - printers
Private Character Editor - (Редактор символов) - eudcedit
Quicktime (Если установлено) - (?) - QuickTime.cpl
Regional Settings - (Язык и региональные стандарты) - intl.cpl
Registry Editor - (Редактор реестра) - regedit
Registry Editor - (редактор реестра платформа х32) - regedit32
Remote Desktop - (Удаленный рабочий стол) - mstsc
Removable Storage - (Съемные запоминающие устройства) - ntmsmgr.msc
Removable Storage Operator Requests - (Запросы операторов съемных запоминающих устройств) - ntmsoprq.msc
Resultant Set of Policy (XP Prof) - (Результирующая политика) - rsop.msc
Scanners and Cameras - (Сканеры и камеры) - sticpl.cpl
Scheduled Tasks control - (Планировщик заданий) - schedtasks
Security Center - (Центр безопасности) - wscui.cpl
Shuts Down Windows - (Завершение работы) - shutdown
Sounds and Audio - (Свойства: звуки и аудиоустройства) - mmsys.cpl
Spider Solitare Card Game - (Пасьянс Паук) - spider
SQL Client Configuration - (Программа сетевого клиента SQL-сервера) - cliconfg
System Configuration Editor - (Редактор файлов настройки) - sysedit
System Configuration Utility - (Утилита настройки системы) - msconfig
System File Checker Utility (Scan Immediately) - (Сканирование дисков/начать сразу) - sfc /scannow
System File Checker Utility (Scan Once At Next Boot) - (Сканирование дисков/один раз при следующей загрузке) - sfc /scanonce
System File Checker Utility (Scan On Every Boot) - (Сканирование дисков/каждый раз при загрузке) - sfc /scanboot
System File Checker Utility (Return to Default Setting) - (Сброс на установки по умолчанию) - sfc /revert
System File Checker Utility (Purge File Cache) - (Очистка фалового кэша) - sfc /purgecache
System File Checker Utility (Set Cache Size to size x) - (Установка размера кэша) - sfc /cachesize=x
System Properties - (Свойства системы) - sysdm.cpl
Task Manager - (Диспетчер задач) - taskmgr
Telnet Client - (Телнет-клиент) - telnet
User Account Management - (Учетные записи пользователей) - nusrmgr.cpl
Utility Manager - (Менеджер служебных программ) - utilman
Windows Firewall - (Брандмауэр Windows) - firewall.cpl
Windows Magnifier - (Экранная лупа) - magnify
Windows Management Infrastructure - (Инфраструктура управления Windows(WMI)) - wmimgmt.msc
Windows System Security Tool - (Защита базы данных учетных записей) - syskey
Windows Update Launches - (Запуск службы обновлений) - wupdmgr
Windows XP Tour Wizard - (Запуск знакомства с Windows) - tourstart
Wordpad - (Запуск редактора Wordpad) - write 
